0, 0, 0, 0, 0, 0, 0, 0, 0, 0, 0, 0, 0, 0, 0, 0, 
0, 0, 0, 0, 0, 0, 0, 0, 0, 0, 0, 0,
0, 0, 0, 0, 0, 0, 0, 0, 0, 0, 0, 0, 7, 0, 0, 0, 
0, 0, 0, 0, 0, 0, 0, 0, 0, 0, 0, 0,
0, 4, 4, 4, 4, 4, 4, 4, 0, 1, 1, 1, 1, 3, 0, 0, 
0, 0, 0, 0, 0, 0, 0, 0, 0, 0, 0, 0,
3, 0, 0, 0, 0, 0, 0, 0, 0, 0, 0, 7, 0, 3, 0, 0, 
0, 0, 7, 0, 0, 0, 0, 0, 0, 7, 0, 0,
3, 0, 0, 0, 0, 0, 0, 0, 0, 3, 9, 9, 9, 9, 0, 1, 
1, 1, 1, 1, 1, 1, 3, 1, 1, 1, 1, 1,
3, 0, 0, 0, 0, 0, 0, 0, 0, 3, 0, 7, 0, 0, 0, 0, 
0, 0, 0, 0, 0, 0, 3, 0, 0, 0, 0, 0,
3, 1, 1, 1, 1, 1, 1, 3, 0, 1, 1, 1, 1, 3, 0, 0, 
0, 0, 0, 0, 0, 0, 3, 0, 0, 0, 0, 0,
3, 0, 0, 0, 0, 0, 0, 3, 0, 0, 0, 7, 0, 3, 0, 3, 
1, 1, 1, 1, 1, 1, 1, 1, 1, 1, 1, 3,
3, 0, 0, 0, 0, 0, 0, 3, 0, 3, 9, 9, 9, 9, 0, 3, 
9, 9, 9, 9, 9, 9, 9, 9, 9, 9, 9, 3,
3, 0, 0, 0, 0, 7, 3, 1, 0, 3, 7, 0, 0, 0, 0, 3, 
9, 0, 0, 0, 0, 0, 7, 0, 0, 0, 9, 3,
3, 0, 0, 0, 0, 3, 1, 0, 0, 1, 1, 1, 1, 3, 0, 3, 
9, 3, 9, 9, 9, 9, 9, 9, 9, 3, 9, 3,
3, 0, 0, 7, 3, 1, 0, 0, 0, 0, 0, 0, 7, 3, 0, 3, 
9, 3, 9, 0, 0, 0, 7, 0, 0, 3, 9, 3,
3, 0, 0, 3, 1, 0, 0, 0, 0, 3, 9, 9, 9, 9, 0, 3, 
9, 3, 9, 9, 9, 9, 9, 9, 9, 9, 9, 3,
3, 0, 3, 1, 0, 0, 0, 0, 0, 3, 0, 7, 0, 0, 0, 3, 
9, 3, 0, 0, 0, 0, 7, 0, 0, 0, 0, 3,
3, 3, 1, 0, 0, 0, 0, 0, 0, 1, 1, 1, 1, 3, 0, 3, 
9, 9, 9, 9, 9, 9, 9, 9, 9, 9, 9, 9,
3, 3, 0, 0, 0, 0, 0, 0, 0, 0, 0, 0, 0, 0, 0, 3, 
0, 0, 0, 0, 0, 0, 0, 0, 0, 0, 0, 0,
1, 1, 1, 1, 1, 1, 1, 1, 1, 1, 1, 1, 1, 1, 1, 1, 
1, 1, 1, 1, 1, 1, 1, 1, 1, 1, 1, 1,
8, 8, 8, 8, 8, 8, 8, 8, 8, 8, 8, 8, 8, 8, 8, 8, 
8, 8, 8, 8, 8, 8, 8, 8, 8, 8, 8, 8,
0, 0, 0, 0, 0, 0, 0, 0, 0, 0, 0, 0, 0, 0, 0, 0, 
0, 0, 0, 0, 0, 0, 0, 0, 0, 0, 0, 0,
0, 0, 0, 0, 0, 0, 0, 0, 0, 0, 0, 0, 0, 0, 0, 0, 
0, 0, 0, 0, 0, 0, 0, 0, 0, 0, 0, 0,
0, 0, 0, 0, 0, 0, 0, 0, 0, 0, 0, 0, 0, 0, 0, 0, 
0, 0, 0, 0, 0, 0, 0, 0, 0, 0, 0, 0