0, 0, 0, 0, 0, 0, 0, 0, 0, 0, 0, 0, 0, 0, 0, 0, 
0, 0, 0, 0, 0, 0, 0, 0, 0, 0, 0, 0,
0, 0, 0, 0, 0, 0, 0, 0, 0, 0, 0, 0, 0, 0, 0, 0, 
0, 0, 0, 0, 0, 0, 0, 0, 0, 0, 0, 0,
0, 0, 0, 0, 0, 0, 0, 0, 0, 0, 0, 0, 0, 0, 0, 0, 
0, 7, 0, 0, 0, 0, 0, 0, 0, 0, 0, 0,
1, 1, 1, 0, 0, 0, 0, 0, 0, 0, 0, 0, 0, 0, 0, 0, 
1, 1, 1, 1, 3, 1, 1, 1, 1, 1, 1, 1,
0, 0, 1, 1, 0, 0, 0, 0, 0, 0, 0, 0, 0, 0, 0, 1, 
1, 0, 0, 0, 3, 0, 0, 0, 0, 0, 0, 0,
0, 0, 0, 1, 1, 0, 0, 0, 0, 0, 0, 0, 0, 0, 1, 1, 
0, 0, 0, 0, 3, 0, 0, 0, 0, 0, 0, 0,
7, 0, 0, 1, 1, 1, 0, 0, 0, 0, 0, 0, 7, 1, 1, 1, 
0, 0, 0, 0, 3, 0, 0, 0, 7, 0, 0, 0,
1, 1, 3, 1, 1, 1, 1, 0, 0, 0, 0, 0, 1, 1, 1, 1, 
3, 1, 1, 1, 3, 1, 1, 1, 1, 1, 1, 1,
0, 0, 3, 0, 0, 0, 1, 1, 0, 0, 0, 1, 1, 0, 0, 0, 
3, 0, 0, 0, 0, 0, 0, 0, 0, 0, 0, 0,
0, 0, 3, 7, 0, 0, 0, 1, 1, 3, 1, 1, 0, 0, 0, 0, 
3, 0, 0, 0, 0, 0, 7, 0, 0, 0, 0, 0,
3, 1, 1, 1, 3, 0, 0, 0, 0, 3, 0, 0, 0, 0, 0, 1, 
3, 1, 1, 3, 1, 1, 1, 0, 0, 0, 0, 0,
3, 0, 0, 0, 3, 0, 0, 0, 0, 0, 0, 0, 0, 0, 0, 0, 
0, 0, 0, 3, 0, 0, 0, 0, 0, 0, 0, 0,
3, 0, 0, 0, 3, 0, 0, 0, 0, 7, 0, 0, 0, 0, 0, 0, 
0, 0, 0, 3, 0, 0, 0, 0, 0, 0, 0, 0,
3, 0, 0, 0, 3, 1, 1, 1, 1, 1, 1, 1, 3, 1, 1, 1, 
1, 1, 1, 3, 1, 1, 1, 1, 1, 3, 1, 1,
3, 0, 0, 0, 0, 0, 0, 0, 0, 0, 0, 0, 3, 0, 0, 0, 
0, 0, 0, 0, 0, 0, 0, 0, 0, 3, 0, 0,
3, 11, 0, 6, 0, 0, 0, 0, 0, 0, 0, 0, 3, 0, 0, 0, 
0, 0, 0, 0, 0, 0, 0, 0, 0, 3, 0, 0,
1, 1, 1, 1, 1, 1, 1, 1, 1, 1, 1, 1, 1, 1, 1, 1, 
1, 1, 1, 1, 1, 1, 1, 1, 1, 1, 1, 1,
8, 8, 8, 8, 8, 8, 8, 8, 8, 8, 8, 8, 8, 8, 8, 8, 
8, 8, 8, 8, 8, 8, 8, 8, 8, 8, 8, 8,
0, 0, 0, 0, 0, 0, 0, 0, 0, 0, 0, 0, 0, 0, 0, 0, 
0, 0, 0, 0, 0, 0, 0, 0, 0, 0, 0, 0,
0, 0, 0, 0, 0, 0, 0, 0, 0, 0, 0, 0, 0, 0, 0, 0, 
0, 0, 0, 0, 0, 0, 0, 0, 0, 0, 0, 0,
0, 0, 0, 0, 0, 0, 0, 0, 0, 0, 0, 0, 0, 0, 0, 0, 
0, 0, 0, 0, 0, 0, 0, 0, 0, 0, 0, 0