0, 0, 0, 0, 0, 0, 0, 0, 0, 0, 0, 0, 0, 0, 0, 0, 
0, 0, 0, 0, 0, 0, 0, 0, 0, 0, 0, 0,
1, 1, 1, 1, 1, 0, 1, 1, 1, 1, 1, 1, 1, 1, 1, 1, 
1, 1, 1, 1, 1, 1, 1, 0, 1, 1, 1, 1,
0, 0, 0, 0, 1, 0, 1, 0, 4, 4, 4, 4, 4, 4, 4, 0, 
0, 0, 0, 0, 0, 0, 0, 0, 0, 0, 0, 1,
0, 1, 1, 0, 0, 0, 1, 0, 1, 7, 0, 0, 0, 1, 3, 1, 
0, 0, 0, 0, 0, 0, 0, 0, 0, 0, 0, 1,
0, 0, 1, 1, 1, 1, 1, 0, 1, 1, 1, 1, 1, 1, 3, 1, 
1, 1, 1, 1, 7, 0, 1, 3, 1, 1, 1, 1,
1, 0, 0, 0, 0, 0, 7, 4, 4, 4, 1, 1, 1, 1, 3, 1, 
1, 1, 1, 1, 1, 1, 1, 3, 1, 0, 1, 1,
1, 1, 1, 1, 1, 1, 1, 0, 0, 0, 1, 0, 0, 1, 3, 1, 
1, 1, 0, 1, 1, 0, 1, 3, 1, 0, 1, 1,
0, 0, 0, 0, 0, 0, 0, 0, 0, 0, 0, 0, 0, 1, 3, 1, 
1, 1, 0, 1, 1, 0, 1, 3, 1, 7, 0, 1,
3, 1, 1, 1, 0, 1, 1, 1, 3, 0, 3, 0, 0, 1, 3, 1, 
1, 1, 0, 1, 1, 0, 1, 3, 1, 1, 1, 1,
3, 0, 0, 0, 0, 0, 0, 0, 3, 0, 1, 1, 1, 1, 3, 1, 
1, 1, 7, 0, 1, 0, 1, 3, 1, 1, 0, 1,
3, 0, 0, 0, 0, 0, 0, 0, 0, 0, 1, 1, 1, 1, 3, 1, 
1, 1, 1, 1, 1, 0, 1, 3, 1, 1, 7, 1,
3, 0, 0, 0, 0, 0, 0, 0, 1, 0, 0, 0, 0, 0, 3, 0, 
0, 0, 0, 0, 0, 0, 0, 3, 0, 0, 0, 1,
3, 1, 1, 1, 3, 1, 1, 1, 1, 3, 1, 9, 1, 9, 1, 9, 
1, 9, 1, 9, 1, 9, 1, 3, 1, 9, 1, 9,
3, 1, 1, 1, 3, 1, 1, 1, 1, 3, 1, 1, 1, 1, 1, 1, 
0, 0, 1, 1, 1, 1, 1, 3, 1, 9, 1, 9,
3, 0, 0, 0, 3, 0, 0, 0, 0, 3, 1, 1, 1, 1, 1, 1, 
1, 0, 0, 1, 1, 1, 1, 3, 0, 0, 0, 0,
3, 1, 1, 1, 1, 1, 1, 1, 1, 3, 1, 1, 1, 1, 1, 1, 
1, 1, 7, 0, 1, 1, 1, 1, 1, 1, 1, 3,
3, 0, 0, 0, 0, 0, 0, 0, 0, 3, 0, 7, 0, 1, 1, 1, 
1, 1, 1, 0, 0, 0, 0, 0, 0, 0, 0, 3,
8, 8, 8, 8, 8, 8, 8, 8, 8, 8, 8, 8, 8, 8, 8, 8, 
8, 8, 8, 8, 8, 8, 8, 8, 8, 8, 8, 8,
0, 0, 0, 0, 0, 0, 0, 0, 0, 0, 0, 0, 0, 0, 0, 0, 
0, 0, 0, 0, 0, 0, 0, 0, 0, 0, 0, 0,
0, 0, 0, 0, 0, 0, 0, 0, 0, 0, 0, 0, 0, 0, 0, 0, 
0, 0, 0, 0, 0, 0, 0, 0, 0, 0, 0, 0,
0, 0, 0, 0, 0, 0, 0, 0, 0, 0, 0, 0, 0, 0, 0, 0, 
0, 0, 0, 0, 0, 0, 0, 0, 0, 0, 0, 0