0, 0, 0, 0, 0, 0, 0, 0, 0, 0, 0, 0, 0, 0, 0, 0, 
0, 0, 0, 0, 0, 0, 0, 0, 0, 0, 0, 0,
0, 0, 0, 0, 0, 0, 0, 0, 0, 0, 0, 0, 3, 3, 3, 0, 
0, 0, 0, 0, 0, 0, 0, 0, 0, 0, 0, 0,
0, 0, 0, 0, 0, 0, 0, 0, 0, 0, 0, 3, 3, 3, 3, 0, 
0, 0, 0, 0, 0, 0, 0, 0, 0, 0, 0, 0,
0, 0, 0, 0, 0, 0, 0, 0, 0, 0, 0, 0, 0, 3, 3, 0, 
0, 0, 0, 0, 0, 0, 0, 0, 0, 0, 0, 0,
0, 0, 0, 0, 0, 0, 0, 0, 0, 0, 0, 0, 3, 3, 3, 3, 
0, 0, 0, 0, 0, 0, 0, 0, 0, 0, 0, 0,
4, 4, 4, 4, 4, 4, 4, 4, 4, 4, 4, 3, 3, 3, 3, 3, 
3, 4, 4, 4, 4, 4, 4, 4, 4, 4, 4, 4,
4, 4, 4, 4, 4, 4, 4, 4, 4, 4, 4, 3, 3, 3, 3, 3, 
3, 4, 4, 4, 4, 4, 4, 4, 4, 4, 4, 4,
0, 4, 4, 4, 4, 4, 4, 4, 4, 4, 4, 3, 3, 3, 3, 3, 
3, 4, 4, 4, 4, 4, 4, 4, 4, 4, 4, 0,
0, 0, 0, 4, 4, 4, 4, 4, 4, 4, 4, 3, 3, 3, 3, 3, 
3, 4, 4, 4, 4, 4, 4, 4, 4, 0, 0, 0,
0, 0, 0, 0, 0, 4, 4, 4, 4, 4, 4, 3, 3, 3, 3, 3, 
3, 4, 4, 4, 4, 4, 4, 0, 0, 0, 0, 0,
0, 0, 0, 0, 0, 0, 0, 0, 4, 4, 4, 3, 3, 3, 3, 3, 
3, 4, 4, 4, 0, 0, 0, 0, 0, 0, 0, 0,
7, 0, 7, 0, 7, 0, 7, 0, 7, 0, 0, 3, 3, 3, 3, 3, 
3, 0, 0, 7, 0, 7, 0, 7, 0, 7, 0, 7,
0, 0, 0, 0, 0, 0, 0, 0, 0, 0, 0, 3, 3, 0, 0, 3, 
3, 0, 0, 0, 0, 0, 0, 0, 0, 0, 0, 0,
1, 1, 1, 1, 1, 1, 1, 1, 1, 1, 1, 3, 3, 1, 1, 3, 
3, 1, 1, 1, 1, 1, 1, 1, 1, 1, 1, 1,
1, 1, 1, 1, 1, 1, 1, 1, 1, 1, 1, 3, 3, 1, 1, 3, 
3, 1, 1, 1, 1, 1, 1, 1, 1, 1, 1, 1,
0, 7, 0, 7, 0, 7, 0, 7, 0, 0, 0, 0, 3, 0, 0, 3, 
0, 0, 0, 0, 7, 0, 7, 0, 7, 0, 7, 0,
1, 1, 1, 1, 1, 1, 1, 1, 1, 1, 1, 1, 1, 1, 1, 1, 
1, 1, 1, 1, 1, 1, 1, 1, 1, 1, 1, 1,
8, 8, 8, 8, 8, 8, 8, 8, 8, 8, 8, 8, 8, 8, 8, 8, 
8, 8, 8, 8, 8, 8, 8, 8, 8, 8, 8, 8,
0, 0, 0, 0, 0, 0, 0, 0, 0, 0, 0, 0, 0, 0, 0, 0, 
0, 0, 0, 0, 0, 0, 0, 0, 0, 0, 0, 0,
0, 0, 0, 0, 0, 0, 0, 0, 0, 0, 0, 0, 0, 0, 0, 0, 
0, 0, 0, 0, 0, 0, 0, 0, 0, 0, 0, 0,
0, 0, 0, 0, 0, 0, 0, 0, 0, 0, 0, 0, 0, 0, 0, 0, 
0, 0, 0, 0, 0, 0, 0, 0, 0, 0, 0, 0