0, 0, 0, 0, 0, 0, 0, 0, 0, 0, 0, 0, 0, 0, 0, 0, 
0, 0, 0, 0, 0, 0, 0, 0, 0, 0, 0, 0,
0, 7, 0, 0, 0, 0, 0, 0, 0, 0, 0, 0, 0, 0, 0, 0, 
0, 0, 0, 0, 0, 0, 0, 0, 0, 0, 0, 0,
1, 1, 1, 1, 3, 0, 0, 0, 0, 0, 0, 0, 0, 0, 0, 0, 
0, 0, 0, 0, 0, 0, 0, 0, 0, 0, 0, 0,
0, 0, 7, 0, 3, 0, 0, 0, 0, 0, 0, 0, 0, 0, 0, 3, 
1, 1, 1, 1, 1, 1, 3, 0, 0, 0, 7, 0,
1, 1, 1, 1, 1, 1, 1, 1, 3, 1, 1, 1, 1, 1, 1, 3, 
0, 0, 0, 0, 0, 1, 1, 1, 1, 1, 1, 1,
0, 0, 0, 0, 0, 0, 0, 0, 3, 0, 0, 0, 0, 0, 0, 3, 
0, 7, 0, 0, 0, 0, 0, 0, 0, 0, 7, 0,
0, 0, 0, 0, 0, 7, 0, 0, 3, 0, 0, 0, 0, 0, 0, 3, 
1, 1, 1, 1, 1, 1, 1, 1, 1, 1, 1, 1,
1, 3, 1, 1, 1, 1, 1, 1, 3, 0, 0, 0, 7, 0, 0, 3, 
0, 0, 0, 0, 0, 0, 0, 0, 0, 0, 0, 0,
0, 3, 0, 0, 0, 7, 0, 0, 3, 9, 9, 9, 9, 9, 9, 3, 
0, 0, 0, 0, 0, 0, 7, 0, 0, 0, 0, 0,
1, 3, 1, 1, 1, 1, 1, 1, 3, 0, 0, 0, 0, 0, 0, 1, 
1, 1, 1, 1, 3, 1, 1, 1, 1, 1, 1, 3,
0, 0, 0, 0, 0, 0, 0, 0, 3, 0, 0, 0, 0, 0, 0, 7, 
0, 0, 0, 0, 3, 0, 0, 0, 0, 0, 0, 3,
0, 7, 0, 0, 0, 0, 0, 0, 3, 1, 1, 1, 3, 1, 1, 1, 
1, 1, 1, 1, 9, 9, 9, 9, 9, 9, 9, 9,
1, 1, 1, 3, 1, 1, 1, 1, 1, 0, 0, 0, 3, 0, 0, 7, 
0, 0, 0, 0, 0, 0, 0, 0, 0, 0, 0, 0,
0, 0, 0, 3, 0, 0, 0, 0, 0, 0, 0, 3, 1, 1, 1, 1, 
1, 1, 1, 1, 3, 1, 1, 1, 1, 1, 1, 1,
0, 0, 0, 3, 4, 4, 4, 4, 4, 4, 4, 3, 0, 0, 0, 0, 
0, 0, 0, 0, 3, 0, 0, 0, 0, 0, 0, 0,
0, 0, 0, 3, 0, 0, 0, 0, 0, 0, 0, 0, 0, 0, 0, 0, 
0, 0, 0, 0, 3, 0, 0, 0, 0, 0, 7, 0,
1, 1, 1, 1, 1, 1, 1, 1, 1, 1, 1, 1, 1, 1, 1, 1, 
1, 1, 1, 1, 1, 1, 1, 1, 1, 1, 1, 1,
8, 8, 8, 8, 8, 8, 8, 8, 8, 8, 8, 8, 8, 8, 8, 8, 
8, 8, 8, 8, 8, 8, 8, 8, 8, 8, 8, 8,
0, 0, 0, 0, 0, 0, 0, 0, 0, 0, 0, 0, 0, 0, 0, 0, 
0, 0, 0, 0, 0, 0, 0, 0, 0, 0, 0, 0,
0, 0, 0, 0, 0, 0, 0, 0, 0, 0, 0, 0, 0, 0, 0, 0, 
0, 0, 0, 0, 0, 0, 0, 0, 0, 0, 0, 0,
0, 0, 0, 0, 0, 0, 0, 0, 0, 0, 0, 0, 0, 0, 0, 0, 
0, 0, 0, 0, 0, 0, 0, 0, 0, 0, 0, 0